#############################
#......,.....#.......,......#
#............#..,.......E...#
#............#..............#
#............########.......#
#....,...O...#......#.......#
#............#....#.#.......#
#.........,..#...,#.#.......#
#............#.,..#......O..#
#########....#.........,..,.#
#.............,.O.#.........#
#.................#....,....#
#....O.,...############.#####
#................,#.........#
#..........#......,.........#
#############################