#############################
#......,.....#..............#
#............#......,.......#
#............#..............#
#............########.......#
#...........................#
#............,......,.......#
#...........................#
#...,.......................#
#...........................#
#.......,...................#
#...............,...........#
#...........................#
#...........................#
#...........................#
#############################