#############################
#......,.....#.......,......#
#............#..,...........#
#............#..............#
#............########.......#
#....,......................#
#...........................#
#.........,......,..........#
#..............,............#
#...........................#
#.............,.............#
#......................,....#
#......,....................#
#................,..........#
#...........................#
#############################