#############################
#............#..............#
#............#..............#
#............#..............#
#............########.......#
#...........................#
#...........................#
#...........................#
#...........................#
#...........................#
#...........................#
#...........................#
#...........................#
#...........................#
#...........................#
#############################