#############################
#......,.....#..............#
#............#......,.......#
#............#.......... ...#
#. ...... ...########.......#
#................... .......#
#............,......,.......#
#.. ........................#
#...,......... .............#
#............,.#.. .........#
#.......,...... ............#
#...............,...... ....#
#...........................#
#...........................#
#....... ...................#
#############################